    changePokemonButton: "Cambia Pokémon",
    searchBattle: "Cerca una lotta",

    wantToBattle: "Vuoi iniziare una lotta?",
    waitForPlayer: "In attesa di un giocatore...",

    noTeam: "Non hai una squadra.",
    TeamFainted: "Ricerca fallita. tutti i tuoi Pokémon sono stanchi",

    // battle
    battlePlayerNotAccepted: "Il tuo avversario ha perso la connessione prima dell'inizio della lotta.<br><br>Riprova.",
    battleCancelled: "La lotta è stata cancellata.",
    battleAlreadyEnded: "La lotta è già conclusa.",
    battleWaitForPlayer: "In attesa del giocatore...",
    battleMoveUsed: (pokemonName, moveName) => `<span class="battle-log-pokemonname" style="color:#63ff78">${pokemonName}</span> usa <span class="battle-log-movename" style="color:#ff6374">${moveName}</span>.`,
    battleMoveFailed: "Ma fallisce...",
    battleAttackMissed: (pokemonName) => `<span class="battle-log-pokemonname" style="color:#63ff78">${pokemonName}</span>attacco non è andato a segno`,
    battleNotEffective: "Non è molto efficace",
    battleEffective: "È superefficace",
    battleNoEffect: "Non ha effetto...",
    battleCriticalHit: "Brutto colpo",
    battleNotAwaitingMove: "Mossa già scelta",
    battleMultipleHits: (amount) => `${amount} colpi!`,
    battleStatUp1: (pokemonName, statName) => `<span class="battle-log-pokemonname" style="color:#63ff78">${pokemonName}</span> ${statName} aumenta.`,
    battleStatUp2: (pokemonName, statName) => `<span class="battle-log-pokemonname" style="color:#63ff78">${pokemonName}</span> ${statName} aumenta di molto!`,
    battleStatUp3: (pokemonName, statName) => `<span class="battle-log-pokemonname" style="color:#63ff78">${pokemonName}</span> ${statName} aumenta drasticamente!`,
    battleStatDown1: (pokemonName, statName) => `<span class="battle-log-pokemonname" style="color:#63ff78">${pokemonName}</span> ${statName} diminuisce.`,
    battleStatDown2: (pokemonName, statName) => `<span class="battle-log-pokemonname" style="color:#63ff78">${pokemonName}</span> ${statName} diminuisce di molto!`,
    battleStatDown3: (pokemonName, statName) => `<span class="battle-log-pokemonname" style="color:#63ff78">${pokemonName}</span> ${statName} diminuisce drasticamente!`,

    // status effects
    battleEnemySleeping: (pokemonName) => `<span class="battle-log-pokemonname" style="color:#63ff78">${pokemonName}</span> si addormenta.`,
    battleEnemyParalysis: (pokemonName) => `<span class="battle-log-pokemonname" style="color:#63ff78">${pokemonName}</span> è paralizzato.`,
    battleEnemyPoison: (pokemonName) => `<span class="battle-log-pokemonname" style="color:#63ff78">${pokemonName}</span> è avvelenato.`,
    battleEnemyToxic: (pokemonName) => `<span class="battle-log-pokemonname" style="color:#63ff78">${pokemonName}</span> è iperavvelenato.`,
    battleEnemyBurned: (pokemonName) => `<span class="battle-log-pokemonname" style="color:#63ff78">${pokemonName}</span> è bruciato.`,
    battleIsParalyzed: (pokemonName) => `<span class="battle-log-pokemonname" style="color:#63ff78">${pokemonName}</span> è paralizzato e non può muoversi.`,
    battleEnemyConfused: (pokemonName) => `<span class="battle-log-pokemonname" style="color:#63ff78">${pokemonName}</span> è confuso`,
    battleEnemyEndConfusion: (pokemonName) => `<span class="battle-log-pokemonname" style="color:#63ff78">${pokemonName}</span> non è più confuso`,
    battleEnemyFrozen: (pokemonName) => `<span class="battle-log-pokemonname" style="color:#63ff78">${pokemonName}</span> è congelato`,
    battleIsSleeping: (pokemonName) => `<span class="battle-log-pokemonname" style="color:#63ff78">${pokemonName}</span> dorme e non può muoversi.`,
    battleConfused: (pokemonName) => `<span class="battle-log-pokemonname" style="color:#63ff78">${pokemonName}</span> è così confuso da colpirsi da solo.`,
    battleIsFrozen: (pokemonName) => `<span class="battle-log-pokemonname" style="color:#63ff78">${pokemonName}</span> è congelato e non può muoversi`,
    battleFlinched: (pokemonName) => `<span class="battle-log-pokemonname" style="color:#63ff78">${pokemonName}</span> sussulta e non può attaccare`,
    battleHealed: (pokemonName) => `<span class="battle-log-pokemonname" style="color:#63ff78">HP di ${pokemonName}</span> sono stati ripristinati.`,
    battleWokeUp: (pokemonName) => `<span class="battle-log-pokemonname" style="color:#63ff78">${pokemonName}</span> è sveglio.`,
    battleUnthawed: (pokemonName) => `<span class="battle-log-pokemonname" style="color:#63ff78">${pokemonName}</span> non è più congelato.`,
    battleRecoilApplied: (pokemonName) => `<span class="battle-log-pokemonname" style="color:#63ff78">${pokemonName}</span> subisce danni da contraccolpo.`,
    battlePoisonDamage: (pokemonName) => `<span class="battle-log-pokemonname" style="color:#63ff78">${pokemonName}</span> subisce danni da avvelenamento.`,
    battleBurnDamage: (pokemonName) => `<span class="battle-log-pokemonname" style="color:#63ff78">${pokemonName}</span> subisce danni da scottatura.`,
    battlePokemonChanged: (LastPokemonName, CurrentPokemonName) => `<span class="battle-log-pokemonname" style="color:#63ff78">${LastPokemonName}</span> viene cambiato con <span class="battle-log-pokemonname" style="color:#63ff78">${CurrentPokemonName}</span>.`,

    // field effects
    battleRainEnd: `Smette di piovere`,
    battleRainStarted: `Inizia a piovere`,
    battleHailStarted: `Inizia a grandinare`,
    battleHailDamage: 'Il Pokémon subisce danni dalla grandine.',
    battleHailEnd: 'Smette di grandinare',
    battleSandstormStarted: "Inizia una tempesta di sabbia",
    battleSandstormDamage: "Il Pokémon subisce danni dalla tempesta di sabbia.",
    battleSandstormEnd: "La tempesta di sabbia è finita.",
    battleSunStarted: `Il sole splende più luminoso che mai.`,
    battleSunEnd: `Il sole torna a splendere normalmente.`,

    // battle ended
    BattleWin: "Congratulations, you won the battle!",
    BattleLose: "You lost the battle!",
    BattleXP: (XP) => `Your team gained ${XP} XP!`,
    BattleNoXP: "Your team didn't receive XP!",